1111111111111
1P010PPP0CCC1
1000011111001
10E011E00P001
1111111111111