1111111111111
1P0100000CCC1
1000011111001
100011E000001
1111111111111