1111111111111
100100000CCC1
1000011111001
1P0011E000001
1111111111111